68 69 70 69 2 2 4 5 6 2 2 2 2 2 17 17 17 17 2 4 5 6 2 2 4 5 6 2 2 
28 29 29 30 2 2 12 13 14 2 4 5 6 2 17 17 17 17 2 12 13 14 2 2 12 13 14 2 2 
44 45 47 46 2 2 20 21 22 2 12 13 14 2 17 17 17 17 2 20 21 22 2 2 20 21 22 2 2 
2 2 2 2 1 2 28 29 30 2 20 21 22 2 17 17 2 2 2 28 29 30 2 2 28 17 30 2 2 
35 43 43 35 2 2 36 39 38 2 28 17 30 2 17 17 2 2 2 36 39 38 2 2 39 45 46 2 2 
17 17 17 17 2 2 44 47 44 2 39 45 46 2 17 17 2 1 2 44 47 44 2 2 2 2 2 2 2 
17 17 17 17 2 1 2 2 2 1 2 2 2 2 42 42 2 2 2 2 2 2 2 1 2 2 2 2 2 
17 17 17 17 42 42 17 17 17 17 17 17 17 17 17 17 17 17 17 17 17 17 17 17 17 17 17 17 17 
17 17 17 17 42 42 17 17 17 17 17 17 17 17 17 17 17 17 17 17 17 17 17 17 17 17 17 17 17 
2 2 1 2 2 2 2 2 2 2 17 2 2 2 2 2 2 2 2 17 17 2 4 5 6 2 42 42 2 
4 5 5 6 2 2 4 5 6 2 17 2 4 5 5 5 5 6 2 17 17 2 12 13 14 2 17 17 2 
12 13 13 14 2 2 12 13 14 2 17 2 12 13 13 13 13 14 105 17 17 2 20 21 22 2 17 17 2 
12 13 13 14 2 2 20 21 22 1 17 2 12 13 13 13 13 14 2 17 17 2 28 17 30 2 17 17 2 
12 13 13 14 1 2 28 17 30 2 17 2 12 13 13 13 13 14 2 17 17 2 39 45 46 2 17 17 2 
20 21 21 22 2 2 39 45 46 2 17 2 20 21 21 21 21 22 2 17 17 2 2 2 2 2 17 17 2 
